|||||||||||||||||||||||||||||||||||||
||   ||    ||                      ||
||   ||    ||         ||           ||
||   ||    ||         ||    %      ||
||   ||    ||         ||           ||
||   ||               ||           ||
||         ||         ||           ||
||   ||    ||  ||||||||||||||||||  ||
||   ||    ||                      ||
|||||||||||||||||||||||||||||||||||||